{


  "LevelName": "Dangerouse",
  "Widht": 10,
  "Height": 10,

  "Spawn": [0,7],
  "spawn_x_flip": false,
  "spawn_y_flip": false,

  "Win" : [8,0],

  "map": [
    [10,15,11,11,11,11,11,11,11,11],
    [15,11,11,19,10,10,10,10,10,10],
    [11,14,13,11,11,11,12,15,11,11],
    [10,10,10,13,11,16,11,11,11,14],
    [11,11,11,10,11,12,10,10,10,10],
    [11,14,10,15,11,11,12,10,11,12],
    [11,12,15,11,14,18,11,10,18,11],
    [11,11,11,14,15,11,14,15,11,14],
    [10,10,10,10,11,19,15,11,19,10],
    [10,10,10,10,11,11,11,16,11,10]
    
  ],

  "hide_traps_count":4,
  "hide_traps": [
    [2,5],
    [9,9],
    [8,4],
    [9,7]
  ],


  "end": false,
  "nextlevelpath": "levels/03.json",

  "save": false

}