{


  "LevelName": "TurboFly",
  "Widht": 15,
  "Height": 15,

  "Spawn": [0,0],
  "spawn_x_flip": false,
  "spawn_y_flip": false,

  "Win" : [7,7],

  "map": [
    [11,11,11,11,11,11,12,10,11,11,11,11,10,11,10],
    [10,10,10,10,10,18,11,10,11,14,18,11,10,11,10],
    [11,11,11,11,10,11,19,10,11,10,11,14,15,11,12],
    [18,11,16,11,10,18,11,10,11,10,11,17,11,16,11],
    [11,19,10,11,10,11,19,10,11,12,13,11,14,15,11],
    [18,11,12,10,10,18,11,10,13,11,12,10,15,11,19],
    [11,11,11,11,11,11,14,10,10,13,11,10,11,16,11],
    [10,10,10,10,10,10,10,11,12,10,10,10,10,10,10],
    [11,11,10,15,11,11,10,11,11,10,11,11,11,11,11],
    [18,11,10,11,16,11,10,11,11,10,11,14,10,13,11],
    [11,11,10,11,10,11,10,13,11,10,11,10,11,10,11],
    [11,19,15,11,10,11,12,10,11,10,11,10,11,10,11],
    [11,11,11,14,10,11,11,10,11,10,11,10,11,10,11],
    [10,18,11,12,10,18,11,10,11,17,11,10,11,17,11],
    [11,11,16,11,10,11,11,10,13,11,14,10,13,11,14]

    
  ],

  "teleport_count": 5,
  "teleport": [
    [5,0,0,14],
    [3,10,13,14],
    [10,8,12,4],
    [14,8,0,0],
    [12,8,0,14]
  ],

  "hide_traps_count":4,
  "hide_traps": [
    [3,0],
    [0,4],
    [0,6],
    [0,8]
  ],


  "end": false,
  "nextlevelpath": "levels/05.json",

  "save": false

}