{


  "LevelName": "Old 15(Crach!!!)",
  "Widht": 10,
  "Height": 10,

  "Spawn": [0,9],
  "spawn_x_flip": false,
  "spawn_y_flip": false,

  "Win" : [9,9],

  "map": [
    [11,11,11,16,11,10,14,11,11,11],  
    [10,10,19,11,13,14,11,18,10,10],
    [14,11,11,13,10,11,17,11,11,12],
    [11,18,10,10,10,10,10,10,19,11],
    [15,11,11,16,11,10,14,11,11,13],  
    [10,10,19,11,13,14,11,18,10,10],
    [14,11,11,13,10,11,17,11,11,12],
    [11,18,10,10,10,10,10,10,19,11],
    [15,11,11,11,12,14,11,11,11,13],
    [10,10,10,15,11,11,13,10,10,10]

    
  ],


  "hide_traps_count":5,
  "hide_traps": [
    [4,9],[4,5],[4,1],[5,3],[5,7]
  ],


  "end": false,
  "nextlevelpath": "levels/09.json",

  "save": false

}