{


  "LevelName": "Infection",
  "Widht": 24,
  "Height": 27,

  "Spawn": [3,11],
  "spawn_x_flip": true,
  "spawn_y_flip": false,

  "Win" : [21,21],

  "map": [
    [10,10,10,10,10,10,10,10,10,10,10,10,10,10,10,10,10,10,10,10,10,10,10,10],
    [10,10,10,10,10,10,10,10,10,10,10,10,15,11,10,10,10,10,10,10,10,10,10,10],  
    [10,15,11,10,10,10,15,11,10,10,10,10,11,19,10,10,10,10,11,11,11,10,10,10],  
    [10,11,19,10,10,10,11,19,10,10,10,10,18,11,10,10,10,15,11,16,11,10,10,10],  
    [10,13,11,10,10,10,13,11,12,10,10,15,11,14,10,10,15,11,14,10,11,12,10,10],  
    [10,15,11,10,10,10,10,18,11,11,11,11,14,10,10,10,11,14,10,10,13,11,10,10],  
    [15,11,14,10,10,10,10,11,19,10,10,10,10,10,10,15,11,12,10,10,10,10,10,10],  
    [11,19,10,10,10,10,10,18,11,10,11,12,10,15,11,11,11,11,12,10,10,10,10,10],  
    [13,11,12,10,10,10,10,11,14,10,11,11,11,11,19,10,10,13,11,12,10,10,10,10],  
    [10,13,11,10,10,10,10,11,10,10,10,10,10,18,11,10,10,10,13,11,12,10,10,10],  
    [10,15,11,10,10,10,15,11,10,10,10,10,15,11,14,10,10,10,10,13,11,11,11,10],  
    [10,11,19,10,10,15,11,14,10,10,10,15,11,19,10,10,10,10,10,10,10,10,10,10],  
    [10,13,11,17,11,11,11,10,10,10,15,11,16,11,11,11,11,12,10,10,10,10,10,10],  
    [10,10,13,11,14,10,10,10,10,10,11,14,10,10,10,10,13,11,10,10,10,10,10,10],  
    [10,10,10,11,12,10,10,10,10,15,11,12,10,10,10,10,10,10,10,10,10,10,10,10],  
    [10,10,10,11,11,11,11,11,11,11,11,11,11,11,11,11,11,10,10,10,10,10,10,10],  
    [10,10,10,11,14,13,11,19,10,10,10,10,10,10,10,13,11,12,10,10,10,10,10,10],  
    [10,10,10,11,10,10,13,11,10,10,10,10,10,10,10,10,13,11,12,10,10,10,10,10],  
    [10,10,10,11,10,10,10,11,10,10,10,10,11,11,11,11,10,13,11,12,10,10,10,10],  
    [10,10,10,11,12,10,10,11,12,10,10,10,10,10,13,11,10,10,13,11,12,10,10,10],  
    [10,10,10,11,11,11,10,13,11,11,12,10,10,10,10,11,10,10,10,13,11,10,10,10],  
    [10,10,10,10,18,11,12,10,10,13,11,11,11,10,10,11,11,12,10,10,11,12,10,10],  
    [10,15,11,17,11,16,11,12,10,10,10,13,11,10,10,13,11,11,10,10,11,11,11,10],  
    [10,11,16,11,14,10,18,11,10,10,10,10,11,12,10,10,10,10,10,10,10,10,10,10],  
    [11,11,10,10,10,10,11,19,10,10,10,10,11,11,10,10,10,10,10,10,10,10,10,10],  
    [10,10,10,10,10,10,13,11,10,10,10,10,10,10,10,10,10,10,10,10,10,10,10,10],
    [10,10,10,10,10,10,10,10,10,10,10,10,10,10,10,10,10,10,10,10,10,10,10,10]
  ],

  "crossbow_count": 3,
  "crossbow": [
    [18,25,0,-1,90],
    [20,25,0,-1,90],
    [6,18,1,0,180]
  ],

  "flamethrower_count":3,
  "flamethrower": [
    [9,23,0,5,3],
    [10,23,1,5,3],
    [17,2,0,2,1]
  ],

  "teleport_count": 1,
  "teleport": [
    [20,4,17,4]
  ],

  "hide_traps_count":5,
  "hide_traps": [
    [2,24],[13,25],[22,16],[22,4],[7,1]
  ],


  "end": false,
  "nextlevelpath": "levels/10.json",

  "save": false

}