{


  "LevelName": "Limo",
  "Widht": 16,
  "Height": 13,

  "Spawn": [4,6],
  "spawn_x_flip": true,
  "spawn_y_flip": false,

  "Win" : [15,6],

  "map": [
    [15,11,11,12,10,15,11,11,11,11,11,11,11,11,10,10],
    [11,14,13,11,10,11,19,10,10,10,10,10,13,11,10,10],
    [11,10,15,11,10,11,11,11,11,11,10,10,15,11,12,10],
    [10,10,11,19,10,10,10,10,10,10,10,15,11,16,11,10],
    [10,15,11,11,12,10,15,11,11,11,11,11,14,10,11,10],
    [10,11,14,13,11,10,11,19,10,10,10,10,10,10,11,12],
    [10,11,12,10,11,10,11,11,11,17,11,11,11,10,11,11],
    [10,18,11,10,10,10,10,10,13,11,11,16,11,12,10,10],
    [15,11,11,12,10,11,11,12,10,10,10,10,13,11,11,12],
    [11,14,13,11,12,10,13,11,12,10,10,10,10,10,13,11],
    [11,12,15,11,11,12,15,11,11,12,10,11,11,12,15,11],
    [18,11,11,14,13,11,11,14,13,11,17,11,16,11,11,14],
    [11,14,10,10,10,10,10,10,10,11,11,14,10,10,10,10],

    
  ],

  "crossbow_count": 1,
  "crossbow": [
    [15,0,-1,1,315]
  ],

  "flamethrower_count":4,
  "flamethrower": [
    [7,5,3,5,0],
    [7,5,2,5,1],
    [7,5,1,5,2],
    [7,5,0,5,3],
  ],

  "items_count": 4,
  "items": [
    [9,10,3],[8,10,2],[7,10,1],[6,10,0]
  ],

  "end": false,
  "nextlevelpath": "levels/11.json",

  "save": true

}