{

"LevelName": "Prison",



"Widht": 12,
"Height": 9,

"Spawn": [11,0],

"spawn_x_flip": false,
"spawn_y_flip": false,

"Win" : [2,7],

"map": [
[10,11,11,11,10,11,11,10,11,11,12,10],
[10,11,11,11,10,11,11,10,11,11,11,12],
[10,11,11,11,10,11,14,10,11,14,15,11],
[10,18,11,19,15,11,12,15,11,10,10,11],
[11,11,11,11,11,11,11,11,11,10,10,10],
[11,16,11,14,13,11,14,13,11,10,11,10],
[11,10,11,12,10,11,12,10,11,12,10,10],
[11,10,11,11,10,11,11,10,11,11,11,12],
[11,10,11,11,10,11,11,10,11,11,16,11]
],
"flimsy_tile_count": 7,
"flimsy_tile": [
  [0,0],[0,2],[2,3],[5,3],[8,3],[5,5],[8,5],[11,7]
],
"end": true,
"nextlevelpath": "levels/14.json",
"save": false
    }