{
  "LevelName": "RunForLive",
  "Spawn": [
    11,
    14
  ],
  "map": [
    [10,10,10,10,10,10,10,10,10,10,10,10,10,10,10,10,10,10],
    [10,11,11,10,10,10,10,10,10,10,10,10,10,10,11,11,11,10],
    [10,11,10,11,10,10,10,10,10,10,10,10,10,10,11,10,10,10],
    [10,10,11,10,11,10,10,10,11,10,11,11,10,11,10,10,10,10],
    [10,11,10,10,10,11,11,11,10,10,10,10,10,10,10,10,10,10],
    [10,11,10,11,11,10,10,10,11,11,10,10,10,10,10,10,10,10],
    [10,10,11,10,10,10,10,10,10,11,10,10,10,10,10,10,10,10],
    [10,10,10,11,11,11,10,10,10,10,11,10,10,10,10,10,10,10],
    [10,10,11,11,10,11,10,10,10,11,10,11,10,10,10,10,10,10],
    [10,10,11,10,10,11,10,11,11,11,10,11,11,11,11,11,10,10],
    [10,10,11,10,10,11,10,11,10,10,10,11,10,10,10,10,10,10],
    [10,10,11,10,10,11,10,11,10,10,10,11,10,10,10,10,10,10],
    [10,10,11,10,10,10,11,11,10,10,10,11,10,11,11,11,10,10],
    [10,10,11,10,10,10,10,10,11,10,10,11,11,10,10,11,10,10],
    [10,10,10,11,11,10,10,10,10,10,10,10,11,10,11,10,10,10],
    [10,10,11,11,10,11,10,10,10,10,10,10,10,11,10,10,10,10],
    [10,11,11,10,10,10,10,10,10,10,10,10,10,10,10,10,10,10],
    [10,10,10,10,10,10,10,10,10,10,10,10,10,10,10,10,10,10]
  ],

    "ReMap": true,

  "Button": [
    {
      "X": 10,
      "Y": 14,
      "Function": [
        "Map:map-9,14>11",
        "Map:map-12,14>11"
      ]
    }
  ],
  "Item": [
    {
      "X": 11,
      "Y": 14,
      "Item": {
        "Type": "speed",
        "Count": 1,
        "Power": 1.75
      },
      "Active": true
    }
  ],
  "Kamikaze": [
    {
      "X": 16,
      "Y": 16,
      "Iters": 15,
      "Radius": 15,
      "Speed": 1.5
    },{
      "X": 16,
      "Y": 16,
      "Iters": 15,
      "Radius": 15,
      "Speed": 1.5
    }
  ]
}